... ... ... ... ... ... ...
... ... ... ... IUL PUL PMA
... ... ... ... ... ... IUA
... ... ... ... ILL PUA PUA
... ... ... ... ... ILL PUA
... ... ... ... ... ... ILL
... ... ... ... ... ... ...