TUA ... ... BMA ... ... ...
... ... BMA ... ... ... ...
... BMA ... DMA ... ... BUL
BMA ... DMA ... ... DUL ...
... ... ... ... DUL ... BUL
... ... ... DUL ... ... ...
... ... BUL ... BUL ... ...