... ... ... ... ... ... ...
... ... IML ... ... ... ...
... ... ... IML IML ... ...
... IMA ... ... ... IML ...
IMA ... IMA ... ... ... ...
... ... ... IMA ... ... ...
... IMA ... ... IMA ... ...