... ... ... ... ... ... ...
... ... ... ... ... ... ...
... ... ... ILL ILL ... ...
... ILA ... ... ... ILL ...
ILA ... ILA ... ... ... ILL
... ... ... ILA ... ... ...
ILA ... ... ... ILA ... ...