... ... ... ... ... ... ...
... ... ... ... ... ... ...
... BML TML ... ... ... ...
... TML TML DML ... ... ...
... ... BML ... ... ... ...
... ... ... ... WMA WMA WMA
... ... ... ... WMA WMA ...