... ... ... ... ... ... ...
... ... ... ... ... ... ...
... LML TML ... ... ... ...
... TML TML EML ... ... ...
... ... LML ... ... ... ...
... ... ... ... WMA WMA WMA
... ... ... ... WMA WMA ...