LL LL LL LL LL LD LL
FF LL LL LL LD LL LL
LL FF LL LL LD LL LL
CD FF LL LD LL LL LL
LL LL LL LD LL LL LL
LL LL LL LD LL LL LL
FF LL FF LL LD LL LL
1
0 3