WW WW WW WW WW WW WW
WW WW TT LL LL LD LL
LL LL LL LL MM MM FF
LL LL LL TT LL FF FF
LL LL LL LL LL LL FF
LL LL LL LL LL LL LL
CC LL LL LL LL LL LD
3
2 1
3 3
0 6