FF FF FF LL LL FF FF
FF FF FF LL LL FF FF
FD FD FD TD LD FD FD
FF FF LL LL TT LL FF
LD LD LD TD LD LD LD
LL LL LL LL LL LL LL
LL LL LL LL LL LL LL