LL LL LD LD LD LD LD
LL LL LD LD LD LD LD
LL LL LD LD LD LD LD
LL LL LL LD LD LD LD
LL LL LL LL LD LD LD
LL LL LL LL LL LD LD
LL LL LL LL LL LL LL
1
0 6