WW WW WW WW WW WW WW
TT WW WW WW WW WW LL
LL LL WW WW WW WW LL
LL LL LL CC LL LL LL
LL LL LL LL LL LL LL
LL LL LL LL LL LL LL
LL LL LL LL LL LL LL
3
0 1
3 6
6 3