LL LL LL LL LL LL LL
LL LL LL LL LL CC LL
LD LD LD LD LD LD LD
LL LL LL LL LL LL LL
CD LD LD LD LD LD LD
LL LL LL LL LL LL LL
LL LL LL LL LL LL LL
1
5 1