LD LL LD FF FF FF FF
LL LD LL FD FF FF FF
LL LD LL LD LL FF FF
LL LL LD LL LD FF FF
LL LL CD LL LD FF FF
LL LL LL LD LL FD FF
LL LL LL LD LL FD FF
2
4 0
6 1